11111111111111111111111111111111111111111111111111111111111111111111111111111111
15000000000000000040010000000040000000000000000000000000000000000000000000000001
10000000000000000000010000000000000000000000000000000000000000000000000000000001
10000000000000000000010000000000000000000000000000000000000000000000004000000001
10000000000000000000010000000000000000000000000000000000000000000000000000000001
10000000000000000000010000000000000000000000000000000000003000000000000000000001
10000000000000000000000000000000000000000000000000000000000000000000000000000001
10000000000000000000000000004000000000000000000000000000000000000000000000000001
10000000000000000000000000000000000000000000000000000000000000000000000000000001
10000000000000000000000000000000000000000000000000000000000000000000000000000001
10000000000000000000000300000000000000000000000000000000000000000000000000000001
10000040000000000000000000000000000000000000000000000000000000000000000000000001
10000000000000000000000000000000000000000000000000000000000000000000200000000001
10000000000000002000000000000000000000000000000000000000000000000000000000000001
10000000000000000000000000000000000000000000000000000000000000000000000000000001
11111111111111111111111111111111111111111000000040000000000000000000000000000001
10000000000000000000000000000000000000000000000000000000000000000000000000000001
10000000000000000000000000000000000000000000000000000000000000000000000000000001
10000000000000000000000000000000000000000000000000000000000000000000000000000001
10000000000000000000000000000000000000000000000000000000000000000000000000000001
10000000000000000000000000000000000000000000000000000000000000000000000000000001
10000000000000000000003000000000000000000000000000000000000000000000000000000001
10000000000040000000000000000000000000000000000000000000000000000000000000000001
10000000000000000000000000000000000000000011111111111111111111111111111111111111
10000000000000000000000000000000000000000000000000000000000000000000004000000001
10000000000000000000000000000000000000000000000000000000000000000000000000000001
10000000000000000000000000000000000000000000000000000000000000000000000000000001
10000000000000000000000000000000000000000000000000000000000000000000000000000001
10000000000000000000000000000004000000000000000000000000000000000000000000000001
10000000000000000000000000000000000000000000000000000000000000000000000000000001
10000000000000020000000000000000000100000000000000000000000000000000000000000001
10000000000000000000000000000000000100000000000000000000000000000000000000000001
10000000000000000000000000000000000100000000000000000000000000000000300000000001
10000004000000000000000000000000000100000000020000000000000000000000000000000001
10000000000000000000000000000000000100000000000000000000000000000000000000000001
10000000000000000000000000000000000100000000000000000000000000000000000000000001
10000000000000300000000000000000000100000000000000000000040000000000000000000001
10000000000000000000000000000000000100000000000000000000000000000000000000000001
10000000000000000000000000000000000100000000000000000000000000000000000000000001
11111111111111111111111111111111111111111111111111111111111111111111111111111111
